For the case n= 27 and m= 12 :
The saturated OA label: 67 
A_idx:  1 2 3 4 5 6 7 8 9 10 11 12 ; B_idx:  13 13 13 13 13 13 13 13 13 13 13 13 
The number of empty cells :  624 ; Variance :  0.3636364 ;
The pattern frequency: ( 0 0 0 0 0.1818182 0 0.5454545 0 0.2727273 ). 
The design D : 
         0 0 0 0 0 0 0 0 0 0 0 0 
         1 1 1 1 4 4 4 4 4 4 4 4 
         2 2 2 2 8 8 8 8 8 8 8 8 
         2 5 5 5 2 2 2 5 5 5 8 8 
         1 4 4 7 1 4 7 1 7 7 1 4 
         2 5 8 5 5 8 5 2 2 8 5 2 
         0 6 3 6 3 0 3 6 6 0 3 6 
         1 7 7 4 7 4 1 7 1 1 7 4 
         0 6 6 6 6 6 6 3 3 3 0 0 
         4 1 4 4 1 7 7 7 4 1 4 1 
         3 0 3 6 3 6 0 3 0 6 6 3 
         5 2 8 8 2 5 5 8 2 5 2 8 
         3 3 0 3 6 0 3 6 3 6 0 3 
         5 5 2 8 8 5 2 5 8 2 5 2 
         3 3 6 0 3 3 6 0 3 0 6 6 
         4 7 1 4 4 7 1 1 7 4 1 7 
         5 8 5 2 8 2 8 2 2 5 5 5 
         4 7 7 1 1 1 4 4 7 7 7 1 
         6 0 3 3 6 3 3 0 6 3 6 0 
         8 2 8 5 5 2 8 5 8 2 2 5 
         7 1 7 7 7 1 1 1 4 7 4 7 
         7 4 1 7 4 1 7 7 1 4 7 1 
         7 4 4 1 7 7 4 4 1 1 1 7 
         6 3 6 0 0 6 0 6 6 3 3 3 
         6 6 0 3 0 3 6 3 0 6 3 6 
         8 8 2 8 2 8 5 2 5 2 8 5 
         8 8 5 2 5 5 2 8 5 8 2 2 

For the case n= 27 and m= 11 :
The saturated OA label: 67 
A_idx:  1 2 3 4 5 6 7 8 9 10 11 ; B_idx:  13 13 13 13 13 13 13 13 13 13 13 
The number of empty cells :  520 ; Variance :  0.3636364 ;
The pattern frequency: ( 0 0 0 0 0.1818182 0 0.5454545 0 0.2727273 ). 
The design D : 
         0 0 0 0 0 0 0 0 0 0 0 
         1 1 1 1 4 4 4 4 4 4 4 
         2 2 2 2 8 8 8 8 8 8 8 
         2 5 5 5 2 2 2 5 5 5 8 
         1 4 4 7 1 4 7 1 7 7 1 
         2 5 8 5 5 8 5 2 2 8 5 
         0 6 3 6 3 0 3 6 6 0 3 
         1 7 7 4 7 4 1 7 1 1 7 
         0 6 6 6 6 6 6 3 3 3 0 
         4 1 4 4 1 7 7 7 4 1 4 
         3 0 3 6 3 6 0 3 0 6 6 
         5 2 8 8 2 5 5 8 2 5 2 
         3 3 0 3 6 0 3 6 3 6 0 
         5 5 2 8 8 5 2 5 8 2 5 
         3 3 6 0 3 3 6 0 3 0 6 
         4 7 1 4 4 7 1 1 7 4 1 
         5 8 5 2 8 2 8 2 2 5 5 
         4 7 7 1 1 1 4 4 7 7 7 
         6 0 3 3 6 3 3 0 6 3 6 
         8 2 8 5 5 2 8 5 8 2 2 
         7 1 7 7 7 1 1 1 4 7 4 
         7 4 1 7 4 1 7 7 1 4 7 
         7 4 4 1 7 7 4 4 1 1 1 
         6 3 6 0 0 6 0 6 6 3 3 
         6 6 0 3 0 3 6 3 0 6 3 
         8 8 2 8 2 8 5 2 5 2 8 
         8 8 5 2 5 5 2 8 5 8 2 

For the case n= 27 and m= 10 :
The saturated OA label: 63 
A_idx:  1 2 3 6 7 8 9 11 12 13 ; B_idx:  10 10 10 10 10 5 5 10 10 10 
The number of empty cells :  478 ; Variance :  0.4 ;
The pattern frequency: ( 0 0 0 0 0.08888889 0.2444444 0.3777778 0.1555556 0.1333333 ). 
The design D : 
         0 0 0 0 0 0 0 0 0 0 
         1 1 1 4 4 4 4 4 4 4 
         2 2 2 8 8 8 8 8 8 8 
         1 4 4 1 1 3 3 7 7 7 
         2 5 5 5 5 7 7 2 2 2 
         2 5 5 8 8 0 0 5 5 5 
         0 6 6 0 0 8 8 3 3 3 
         0 6 6 3 3 1 1 6 6 6 
         1 7 7 7 7 5 5 1 1 1 
         3 0 3 3 6 2 5 0 3 6 
         3 0 3 6 0 4 7 3 6 0 
         4 1 4 1 4 8 2 7 1 4 
         3 3 6 6 3 6 3 0 6 3 
         4 4 7 1 7 1 7 4 1 7 
         5 5 8 5 2 5 2 8 5 2 
         4 7 1 4 7 6 0 4 7 1 
         5 8 2 8 2 1 4 8 2 5 
         5 8 2 2 5 3 6 2 5 8 
         7 1 7 7 4 0 6 7 4 1 
         8 2 8 2 8 4 1 2 8 5 
         8 2 8 5 2 6 3 5 2 8 
         6 3 0 6 3 5 2 3 0 6 
         6 3 0 0 6 7 4 6 3 0 
         7 4 1 4 1 2 8 1 7 4 
         6 6 3 3 6 3 6 6 0 3 
         7 7 4 7 1 7 1 1 4 7 
         8 8 5 2 5 2 5 5 8 2 

For the case n= 27 and m= 9 :
The saturated OA label: 66 
A_idx:  1 2 3 4 5 6 7 8 9 ; B_idx:  13 13 13 10 10 10 12 11 12 
The number of empty cells :  288 ; Variance :  0.2962963 ;
The pattern frequency: ( 0 0 0 0 0 0 0.6666667 0 0.3333333 ). 
The design D : 
         0 0 0 0 0 0 0 0 0 
         1 1 1 1 4 4 4 4 4 
         2 2 2 5 2 5 8 8 8 
         2 5 5 1 7 7 2 2 5 
         1 4 4 6 0 6 7 7 1 
         0 3 3 8 8 5 3 3 6 
         2 8 8 5 5 8 1 3 1 
         0 6 6 3 6 0 5 7 5 
         1 7 7 7 4 1 6 2 6 
         3 0 3 4 4 7 0 7 6 
         4 1 4 5 8 2 4 2 1 
         5 2 5 6 3 0 8 3 5 
         4 4 7 2 2 2 2 4 8 
         5 5 8 0 3 3 3 8 0 
         3 3 6 4 1 4 7 0 4 
         3 6 0 0 6 6 7 5 7 
         5 8 2 8 2 8 3 1 3 
         4 7 1 7 7 4 2 6 2 
         7 1 7 2 8 8 6 6 3 
         6 0 6 7 1 7 5 5 2 
         8 2 8 6 6 3 1 1 7 
         7 4 1 3 3 6 5 0 8 
         8 5 2 4 7 1 6 4 0 
         6 3 0 8 5 2 1 8 4 
         8 8 5 1 1 1 4 6 7 
         6 6 3 2 5 5 8 1 2 
         7 7 4 3 0 3 0 5 3 

For the case n= 27 and m= 8 :
The saturated OA label: 66 
A_idx:  1 2 3 4 5 6 7 8 ; B_idx:  13 13 13 10 10 10 12 11 
The number of empty cells :  216 ; Variance :  0.2857143 ;
The pattern frequency: ( 0 0 0 0 0 0 0.6428571 0 0.3571429 ). 
The design D : 
         0 0 0 0 0 0 0 0 
         1 1 1 1 4 4 4 4 
         2 2 2 5 2 5 8 8 
         2 5 5 1 7 7 2 2 
         1 4 4 6 0 6 7 7 
         0 3 3 8 8 5 3 3 
         2 8 8 5 5 8 1 3 
         0 6 6 3 6 0 5 7 
         1 7 7 7 4 1 6 2 
         3 0 3 4 4 7 0 7 
         4 1 4 5 8 2 4 2 
         5 2 5 6 3 0 8 3 
         4 4 7 2 2 2 2 4 
         5 5 8 0 3 3 3 8 
         3 3 6 4 1 4 7 0 
         3 6 0 0 6 6 7 5 
         5 8 2 8 2 8 3 1 
         4 7 1 7 7 4 2 6 
         7 1 7 2 8 8 6 6 
         6 0 6 7 1 7 5 5 
         8 2 8 6 6 3 1 1 
         7 4 1 3 3 6 5 0 
         8 5 2 4 7 1 6 4 
         6 3 0 8 5 2 1 8 
         8 8 5 1 1 1 4 6 
         6 6 3 2 5 5 8 1 
         7 7 4 3 0 3 0 5 

For the case n= 27 and m= 7 :
The saturated OA label: 61 
A_idx:  1 2 3 6 7 12 13 ; B_idx:  9 11 11 11 11 5 5 
The number of empty cells :  140 ; Variance :  0.2469136 ;
The pattern frequency: ( 0 0 0 0 0 0 0.4285714 0.1904762 0.3809524 ). 
The design D : 
         0 0 0 0 0 0 0 
         1 1 1 4 4 4 4 
         2 2 2 8 8 8 8 
         1 5 5 2 2 6 6 
         2 3 3 3 3 1 1 
         0 4 4 7 7 3 3 
         2 7 7 1 1 5 5 
         0 8 8 5 5 7 7 
         1 6 6 6 6 2 2 
         4 0 3 3 6 5 8 
         5 1 4 7 1 7 1 
         3 2 5 2 5 2 5 
         5 5 8 5 8 0 3 
         3 3 6 6 0 4 7 
         4 4 7 1 4 8 2 
         5 7 1 7 4 0 6 
         3 8 2 2 8 4 1 
         4 6 0 3 0 6 3 
         6 1 7 4 7 6 0 
         7 2 8 8 2 1 4 
         8 0 6 0 3 3 6 
         6 3 0 6 3 8 5 
         7 4 1 1 7 1 7 
         8 5 2 5 2 5 2 
         7 8 5 8 5 3 0 
         8 6 3 0 6 7 4 
         6 7 4 4 1 2 8 