For the case n= 27 and m= 12 :
The saturated OA label: 35 
A_idx:  1 2 3 4 5 6 7 8 9 10 11 12 ; B_idx:  13 13 13 13 13 13 13 13 13 13 13 13 
The number of empty cells :  432 ; Variance :  0.3636364 ;
The pattern frequency: ( 0.1818182 0 0 0 0 0 0 0 0.8181818 ). 
The design D : 
         0 0 0 0 0 0 0 0 0 0 0 0 
         1 1 1 1 4 4 4 4 4 4 4 4 
         2 2 2 2 8 8 8 8 8 8 8 8 
         2 5 5 5 2 2 2 5 5 5 8 8 
         0 3 3 3 3 3 3 6 6 6 0 0 
         1 4 4 4 7 7 7 1 1 1 4 4 
         1 7 7 7 1 1 1 7 7 7 4 4 
         2 8 8 8 5 5 5 2 2 2 8 8 
         0 6 6 6 6 6 6 3 3 3 0 0 
         5 2 5 8 2 5 8 2 5 8 2 5 
         3 0 3 6 3 6 0 3 6 0 3 6 
         4 1 4 7 7 1 4 7 1 4 7 1 
         4 4 7 1 1 4 7 4 7 1 7 1 
         5 5 8 2 5 8 2 8 2 5 2 5 
         3 3 6 0 6 0 3 0 3 6 3 6 
         3 6 0 3 0 3 6 6 0 3 3 6 
         4 7 1 4 4 7 1 1 4 7 7 1 
         5 8 2 5 8 2 5 5 8 2 2 5 
         7 1 7 4 1 7 4 1 7 4 1 7 
         8 2 8 5 5 2 8 5 2 8 5 2 
         6 0 6 3 6 3 0 6 3 0 6 3 
         6 3 0 6 0 6 3 3 0 6 6 3 
         7 4 1 7 4 1 7 7 4 1 1 7 
         8 5 2 8 8 5 2 2 8 5 5 2 
         8 8 5 2 2 8 5 8 5 2 5 2 
         6 6 3 0 3 0 6 0 6 3 6 3 
         7 7 4 1 7 4 1 4 1 7 1 7 

For the case n= 27 and m= 11 :
The saturated OA label: 35 
A_idx:  1 2 3 4 5 6 7 8 9 10 11 ; B_idx:  13 13 13 13 13 13 13 13 13 13 13 
The number of empty cells :  360 ; Variance :  0.3636364 ;
The pattern frequency: ( 0.1818182 0 0 0 0 0 0 0 0.8181818 ). 
The design D : 
         0 0 0 0 0 0 0 0 0 0 0 
         1 1 1 1 4 4 4 4 4 4 4 
         2 2 2 2 8 8 8 8 8 8 8 
         2 5 5 5 2 2 2 5 5 5 8 
         0 3 3 3 3 3 3 6 6 6 0 
         1 4 4 4 7 7 7 1 1 1 4 
         1 7 7 7 1 1 1 7 7 7 4 
         2 8 8 8 5 5 5 2 2 2 8 
         0 6 6 6 6 6 6 3 3 3 0 
         5 2 5 8 2 5 8 2 5 8 2 
         3 0 3 6 3 6 0 3 6 0 3 
         4 1 4 7 7 1 4 7 1 4 7 
         4 4 7 1 1 4 7 4 7 1 7 
         5 5 8 2 5 8 2 8 2 5 2 
         3 3 6 0 6 0 3 0 3 6 3 
         3 6 0 3 0 3 6 6 0 3 3 
         4 7 1 4 4 7 1 1 4 7 7 
         5 8 2 5 8 2 5 5 8 2 2 
         7 1 7 4 1 7 4 1 7 4 1 
         8 2 8 5 5 2 8 5 2 8 5 
         6 0 6 3 6 3 0 6 3 0 6 
         6 3 0 6 0 6 3 3 0 6 6 
         7 4 1 7 4 1 7 7 4 1 1 
         8 5 2 8 8 5 2 2 8 5 5 
         8 8 5 2 2 8 5 8 5 2 5 
         6 6 3 0 3 0 6 0 6 3 6 
         7 7 4 1 7 4 1 4 1 7 1 

For the case n= 27 and m= 10 :
The saturated OA label: 35 
A_idx:  1 2 3 4 5 6 7 8 9 11 ; B_idx:  13 13 13 12 12 13 13 13 13 13 
The number of empty cells :  252 ; Variance :  0.3111111 ;
The pattern frequency: ( 0.1555556 0 0 0 0 0 0 0 0.8444444 ). 
The design D : 
         0 0 0 0 0 0 0 0 0 0 
         1 1 1 1 4 4 4 4 4 4 
         2 2 2 2 8 8 8 8 8 8 
         2 5 5 5 2 2 2 5 5 8 
         0 3 3 3 3 3 3 6 6 0 
         1 4 4 4 7 7 7 1 1 4 
         1 7 7 7 1 1 1 7 7 4 
         2 8 8 8 5 5 5 2 2 8 
         0 6 6 6 6 6 6 3 3 0 
         5 2 5 7 1 5 8 2 5 2 
         3 0 3 8 5 6 0 3 6 3 
         4 1 4 6 6 1 4 7 1 7 
         4 4 7 0 0 4 7 4 7 7 
         5 5 8 1 4 8 2 8 2 2 
         3 3 6 2 8 0 3 0 3 3 
         3 6 0 5 2 3 6 6 0 3 
         4 7 1 3 3 7 1 1 4 7 
         5 8 2 4 7 2 5 5 8 2 
         7 1 7 5 2 7 4 1 7 1 
         8 2 8 3 3 2 8 5 2 5 
         6 0 6 4 7 3 0 6 3 6 
         6 3 0 7 1 6 3 3 0 6 
         7 4 1 8 5 1 7 7 4 1 
         8 5 2 6 6 5 2 2 8 5 
         8 8 5 0 0 8 5 8 5 5 
         6 6 3 1 4 0 6 0 6 6 
         7 7 4 2 8 4 1 4 1 1 

For the case n= 27 and m= 9 :
The saturated OA label: 35 
A_idx:  1 2 3 4 5 6 7 8 11 ; B_idx:  13 13 13 12 13 12 13 10 13 
The number of empty cells :  162 ; Variance :  0.25 ;
The pattern frequency: ( 0.125 0 0 0 0 0 0 0 0.875 ). 
The design D : 
         0 0 0 0 0 0 0 0 0 
         1 1 1 1 4 4 4 4 4 
         2 2 2 2 8 8 8 8 8 
         2 5 5 5 2 2 2 4 8 
         0 3 3 3 3 3 3 8 0 
         1 4 4 4 7 7 7 0 4 
         1 7 7 7 1 1 1 8 4 
         2 8 8 8 5 5 5 0 8 
         0 6 6 6 6 6 6 4 0 
         5 2 5 7 2 4 8 2 2 
         3 0 3 8 3 8 0 3 3 
         4 1 4 6 7 0 4 7 7 
         4 4 7 0 1 3 7 3 7 
         5 5 8 1 5 7 2 7 2 
         3 3 6 2 6 2 3 2 3 
         3 6 0 5 0 5 6 7 3 
         4 7 1 3 4 6 1 2 7 
         5 8 2 4 8 1 5 3 2 
         7 1 7 5 1 8 4 1 1 
         8 2 8 3 5 0 8 5 5 
         6 0 6 4 6 4 0 6 6 
         6 3 0 7 0 7 3 5 6 
         7 4 1 8 4 2 7 6 1 
         8 5 2 6 8 3 2 1 5 
         8 8 5 0 2 6 5 6 5 
         6 6 3 1 3 1 6 1 6 
         7 7 4 2 7 5 1 5 1 

For the case n= 27 and m= 8 :
The saturated OA label: 35 
A_idx:  1 2 3 4 5 6 8 9 ; B_idx:  11 7 12 12 12 11 12 11 
The number of empty cells :  108 ; Variance :  0.2142857 ;
The pattern frequency: ( 0.1071429 0 0 0 0 0 0 0 0.8928571 ). 
The design D : 
         0 0 0 0 0 0 0 0 
         1 1 1 1 4 4 4 4 
         2 2 2 2 8 8 8 8 
         2 3 5 5 2 2 5 5 
         0 4 3 3 3 3 6 6 
         1 5 4 4 7 7 1 1 
         1 6 7 7 1 1 7 7 
         2 7 8 8 5 5 2 2 
         0 8 6 6 6 6 3 3 
         3 2 4 7 1 3 1 3 
         4 0 5 8 5 7 5 7 
         5 1 3 6 6 2 6 2 
         5 5 6 0 0 5 3 8 
         3 3 7 1 4 6 7 0 
         4 4 8 2 8 1 2 4 
         4 8 2 5 2 4 8 1 
         5 6 0 3 3 8 0 5 
         3 7 1 4 7 0 4 6 
         6 1 8 5 2 6 2 6 
         7 2 6 3 3 1 3 1 
         8 0 7 4 7 5 7 5 
         8 4 1 7 1 8 4 2 
         6 5 2 8 5 0 8 3 
         7 3 0 6 6 4 0 7 
         7 7 3 0 0 7 6 4 
         8 8 4 1 4 2 1 8 
         6 6 5 2 8 3 5 0 

For the case n= 27 and m= 7 :
The saturated OA label: 35 
A_idx:  1 2 3 5 6 8 9 ; B_idx:  11 7 12 4 13 13 4 
The number of empty cells :  54 ; Variance :  0.1428571 ;
The pattern frequency: ( 0.07142857 0 0 0 0 0 0 0 0.9285714 ). 
The design D : 
         0 0 0 0 0 0 0 
         1 1 1 3 4 4 3 
         2 2 2 6 8 8 6 
         2 3 5 1 2 5 4 
         0 4 3 4 3 6 7 
         1 5 4 7 7 1 1 
         1 6 7 2 1 7 8 
         2 7 8 5 5 2 2 
         0 8 6 8 6 3 5 
         3 2 4 2 5 2 5 
         4 0 5 5 6 3 8 
         5 1 3 8 1 7 2 
         5 5 6 0 4 4 6 
         3 3 7 3 8 8 0 
         4 4 8 6 0 0 3 
         4 8 2 1 3 6 1 
         5 6 0 4 7 1 4 
         3 7 1 7 2 5 7 
         6 1 8 1 7 1 7 
         7 2 6 4 2 5 1 
         8 0 7 7 3 6 4 
         8 4 1 2 6 3 2 
         6 5 2 5 1 7 5 
         7 3 0 8 5 2 8 
         7 7 3 0 8 8 3 
         8 8 4 3 0 0 6 
         6 6 5 6 4 4 0 